NO ./textures/walls/n_walls_0.xpm
SO ./textures/walls/s_walls_0.xpm
WE ./textures/walls/w_walls_0.xpm
EA ./textures/walls/e_walls_0.xpm

F 128, 128, 128
C 153, 204, 255



   11111111
1M001    01
1D10001
1DD00N11111
111111111