   111111
1001    01
101001
1100N11111
111111