   11111111
10001    01
1010001
1100N11111
111111111