NO ./textures/n_walls_0.xpm
SO ./textures/s_walls_0.xpm
WE ./textures/w_walls_0.xpm
EA ./textures/e_walls_0.xpm

F 128, 128, 128
C 153, 204, 255






         1111111111111111111111111
        1000000000110000000000001
1          011000001110000000000001
            1001000000000M00000000001
111111111011000001110000000000001
100000000011000001110111111111111
11110111111111011100000010M01
11110111111111011101010010M1
110000001101D1011100000000M11
1000000000MMMMM00000000010001
10000000000000000001010010001
11000001110101011111011110N0111
11110111 1110101 101111010001
11111111 1111111 11111111111