NO ./textures/n_wall.xpm
SO ./textures/s_wall_0.xpm
WE ./textures/w_wall_0.xpm
EA ./textures/e_wall_0.xpm

F 128, 128, 128
C 153, 204, 255



   11111111
1C001    01
1010001
10D00N11111
111111111