NO ./textures/n_wall.xpm
SO ./textures/s_wall.xpm
WE ./textures/w_wall.xpm
EA ./textures/e_wall.xpm

F 128, 128, 128
C 153, 204, 255



   11111111
10001    01
1010001
11000N11111
111111111