NO ./textures/n_walls_0.xpm
SO ./textures/s_walls_0.xpm
WE ./textures/w_walls_0.xpm
EA ./textures/e_walls_0.xpm

F 128, 128, 128
C 153, 204, 255



   11111111
10001    01
1010001
10000N11111
111111111