NO ./textures/n_wall.xpm
SO ./textures/s_wall.xpm
WE ./textures/w_wall.xpm
EA ./textures/e_wall.xpm

F 128, 128, 128
C 153, 204, 255

 111111111111111111111111111111111111111111111111111111111111111
 1100000000000011100S0010000000000000001000001000001000001000001
 100011111111000010000010000000000001000000001000001000001000001
 100011111111000010000010000100000001001000001000001000001000001
1101111111111111111000111111111111111111000001000001000001000001
1000000000001000000000000000100000000011000001000001000001000001
1000000000000000000000000000000000000011110111110111110111110111
1000000000001000000000000000100000000001000000000000000000000001
1000011111111111111101111111111111100001000000000000000000000001
1100110000011000001000100000110000100000000000000000000000000001
1100110000001000000000000000100000100001000000000000000000000001
1100110000001000001000100000100000100001000000000000000000000001
1000011111101111111111111111101111100011110111110111110111110111
1000000111000111000111000000000000000011000001000001000001000001
1000000000000000000000000000000000000011000001000001000001000001
1000000000000000000000000000000000000011000001000001000001000001
1000000111000111000000000000000001110011000001000001000001000001
1111111111111111111000111111000111111111000001000001000001000001
1111111111111111111101111111101111111111111111111111111111111111
1000000000000001100000000000000000000001111111111111111111111111
1000000000000001100000000000000000000001000000000000000000000001
1011111111111111100000000000000000000001000000000000000000000001
1011111111111111111111111111111111110001000000000000000000000001
1011000000011111111100000001100000110001000111111111111111110001
1011000000010000000100000001000000010001000100000001000000010001
1011000000010000000100000001000000010001000100000001000000010001
1011000000000000000000000000000000010001000100000001000000010001
1011000000010000000100000001000000010001000100000001000000010001
1011000000010000000100000001000000010001000100000001000000010001
1011000000011111111100000001100000110001000111111011101111110001
1011111011111111111111111111111111111111000000000000000000000001
1011100000110000000000000000111111110001000000000000000000000001
1011000000010000000000000000100000010001000000000000000000000001
1011000000010000000000000000100000010001111111111111111111111011
1011000000010000000000000000100000000001000000000000000000010001
1011000000010000000000000000100000010001000000000000000000010001
1011000000010000000000000000100000010001000000000000000000010001
1011100000110000000000000000100000010001000111110001111100010001
1011111011111111111111111111111011110001000100000001000100010001
1011100000010000000100000001000000010001000100000001000100010001
1011000000010000000100000001000000010001000100000001000100010001
1011100000010000000100000001000000010001101111110001101100010001
1011000000000000001100000001000000000001000111110000000000010001
1011100000010000000100000001000000010001000111100000000000010001
1011000000010000000100000001000000010001000111110000000000010001
1011101010110000000100000001000000010001000000111111111111110001
1011111111111110111111111111111111110001000100000000000000010001
1011000000011000000100000111000000010001000100000000000000010001
1011000000010000000100000111000000010001000100000000000000010001
1011000000010000000100000001000000010001101111111111111100010001
1011000000000000000000000000000000000001000000000000000100010001
1011000000010000000100000001000000010001000000000000000100010001
1011100000010000000111000111000000010001000000000000000100010001
1011010000010000001001000101000000010001111110111111000100010001
1011001011111111111111111111111111110001000000000001000100010001
1011111011110000000000000001000000010001000000000001000100010001
1011000000010000000000000001000000010001001000001001000100010001
1011000000010000000000000001000000010001000000000001000100010001
1011111111010000000000000001000000000000000000000000000100010001
1011011000010000000000000001000000010001000000000001000111110001
1000011000010000000000000001000000011111001000001001000100000001
1111011011110000000000000001000000010001000000000001000000000001
1110000000010000000000000001111111111011000000000001000100000001
1111111111111111111111111111111111111111111111111111111111111111